::::::::::::::::::::::::::::::::::::::::::::::::::::::::::::::::::::::::::::::::::::::::::::::::::::
::::::::::::::::::::::::::::::::::::::::::::::::::::::::::::::::::::::::::::::::::::::::::::::::::::
::::::::::::::::::::::::::::::::::::::::::::::::::::::::::::::::::::::::::::::::::::::::::::::::::::
::::::::::::::::::::::::::::::::::::::::::::::::::::::::::::::::::::::::::::::::::::::::::::::::::::
::::::::::::::::::::::::::::::::::::::::::::::::::::::::::::::::::::::::::::::::::::::::::::::::::::
::::::::::::::::::::::::::::::::::::::::::::::::::::::::::::::::::::::::::::::::::::::::::::::::::::
::::::::::::::::::::::::::::::::::::::::::::::::::::::::::::::::::::::::::::::::::::::::::::::::::::
::::::::::::::::::::::::::::::::::::::::::::::::::::::::::::::::::::::::::::::::::::::::::::::::::::
::::::::::::::::::::::::::::::::::::::::::::::::::::::::::::::::::::::::::::::::::::::::::::::::::::
::::::::::::::::::::::::::::::::::::::::::::::::::::::::::::::::::::::::::::::::::::::::::::::::::::
::::::::::::::::::::::::::::::::::::::::::::::::::::::::::::::::::::::::::::::::::::::::::::::::::::
::::::::::::::::::::::::::::::::::::::::::::::::::::::::::::::::::::::::::::::::::::::::::::::::::::
::::::::::::::::::::::::::::::::::::::::::::::::::::::::::::::::::::::::::::::::::::::::::::::::::::
::::::::::::::::::::::::::::::::::::::::::::::::::::::::::::::::::::::::::::::::::::::::::::::::::::
::::::::::::::::::::::::::::::::::::::::::::::::::::::::::::::::::::::::::::::::::::::::::::::::::::
::::::::::::::::::::::::::::::::::::::::::::::::::::::::::::::::::::::::::::::::::::::::::::::::::::
::::::::::::::::::::::::::::::::::::::::::::::::::::::::::::::::::::::::::::::::::::::::::::::::::::
::::::::::::::::::::::::::::::::::::::::::::::::::::::::::::::::::::::::::::::::::::::::::::::::::::
::::::::::::::::::::::::::::::::::::::::::::::::::::::::::::::::::::::::::::::::::::::::::::::::::::
::::::::::::::::::::::::::::::::::::::::::::::::::::::::::::::::::::::::::::::::::::::::::::::::::::
::::::::::::::::::::::::::::::::::::::::::::::::::::::::::::::::::::::::::::::::::::::::::::::::::::
::::::::::::::::::::::::::::::::::::::::::::::::::::::::::::::::::::::::::::::::::::::::::::::::::::
::::::::::::::::::::::::::::::::::::::::::::::::::::::::::::::::::::::::::::::::::::::::::::::::::::
::::::::::::::::::::::::::::::::::::::::::::::::::::::::::::::::::::::::::::::::::::::::::::::::::::
::::::::::::::::::::::::::::::::::::::::::::::::::::::::::::::::::::::::::::::::::::::::::::::::::::
:::::::::::::::::::::::::###################################################::::::::::::::::::::::::
:::::::::::::::::::::::::#~~~~~~~~~~~~~~~~~~~~~~~~~~~~~~~~~~~~~~~~~~~~~~~~~#::::::::::::::::::::::::
:::::::::::::::::::::::::#~~~~~~~~~~~~~~~~~~~~~~~~~~~~~~~~~~~~~~~~~~~~~~~~~#::::::::::::::::::::::::
:::::::::::::::::::::::::#~~~~~~~~~~~~~~~~~~~~~~~~~~~~~~~~~~~~~~~~~~~~~~~~~#::::::::::::::::::::::::
:::::::::::::::::::::::::#~~~~~~~~~~~~~~~~~~~~~~~~~~~~~~~~~~~~~~~~~~~~~~~~~#::::::::::::::::::::::::
:::::::::::::::::::::::::#~~~~~~~~~~~~~~~~~~~~~~~~~~~~~~~~~~~~~~~~~~~~~~~~~#::::::::::::::::::::::::
:::::::::::::::::::::::::#~~~~~~~~~~~~~~~~~~~#############~~~~~~~~~~~~~~~~~#::::::::::::::::::::::::
:::::::::::::::::::::::::#~~~~~~~~~~~~~~~~##################~~~~~~~~~~~~~~~#::::::::::::::::::::::::
:::::::::::::::::::::::::#~~~~~~~~~~~~~~#####################~~~~~~~~~~~~~~#::::::::::::::::::::::::
:::::::::::::::::::::::::#~~~~~~~~~~~~~########################~~~~~~~~~~~~#::::::::::::::::::::::::
:::::::::::::::::::::::::#~~~~~~~~~~~~###########################~~~~~~~~~~#::::::::::::::::::::::::
:::::::::::::::::::::::::#~~~~~~~~~~#############################~~~~~~~~~~#::::::::::::::::::::::::
:::::::::::::::::::::::::#~~~~~~~~~~###############################~~~~~~~~#::::::::::::::::::::::::
:::::::::::::::::::::::::#~~~~~~~~~################################~~~~~~~~#::::::::::::::::::::::::
:::::::::::::::::::::::::#~~~~~~~~##################################~~~~~~~#::::::::::::::::::::::::
:::::::::::::::::::::::::#~~~~~~~###################################~~~~~~~#::::::::::::::::::::::::
:::::::::::::::::::::::::#~~~~~~~####################################~~~~~~#::::::::::::::::::::::::
:::::::::::::::::::::::::#~~~~~~#####################################~~~~~~#::::::::::::::::::::::::
:::::::::::::::::::::::::#~~~~~~######################################~~~~~#::::::::::::::::::::::::
:::::::::::::::::::::::::#~~~~~~#######################################~~~~#::::::::::::::::::::::::
:::::::::::::::::::::::::#~~~~~########################################~~~~#::::::::::::::::::::::::
:::::::::::::::::::::::::#~~~~~########################################~~~~#::::::::::::::::::::::::
:::::::::::::::::::::::::#~~~~~########################################~~~~#::::::::::::::::::::::::
:::::::::::::::::::::::::#~~~~~########################################~~~~#::::::::::::::::::::::::
:::::::::::::::::::::::::#~~~~~########################################~~~~#::::::::::::::::::::::::
:::::::::::::::::::::::::#~~~~#########################################~~~~#::::::::::::::::::::::::
:::::::::::::::::::::::::#~~~~~########################################~~~~#::::::::::::::::::::::::
:::::::::::::::::::::::::#~~~~~########################################~~~~#::::::::::::::::::::::::
:::::::::::::::::::::::::#~~~~~########################################~~~~#::::::::::::::::::::::::
:::::::::::::::::::::::::#~~~~~########################################~~~~#::::::::::::::::::::::::
:::::::::::::::::::::::::#~~~~~########################################~~~~#::::::::::::::::::::::::
:::::::::::::::::::::::::#~~~~~########################################~~~~#::::::::::::::::::::::::
:::::::::::::::::::::::::#~~~~~~######################################~~~~~#::::::::::::::::::::::::
:::::::::::::::::::::::::#~~~~~~######################################~~~~~#::::::::::::::::::::::::
:::::::::::::::::::::::::#~~~~~~######################################~~~~~#::::::::::::::::::::::::
:::::::::::::::::::::::::#~~~~~~~####################################~~~~~~#::::::::::::::::::::::::
:::::::::::::::::::::::::#~~~~~~~####################################~~~~~~#::::::::::::::::::::::::
:::::::::::::::::::::::::#~~~~~~~~##################################~~~~~~~#::::::::::::::::::::::::
:::::::::::::::::::::::::#~~~~~~~~~################################~~~~~~~~#::::::::::::::::::::::::
:::::::::::::::::::::::::#~~~~~~~~~~##############################~~~~~~~~~#::::::::::::::::::::::::
:::::::::::::::::::::::::#~~~~~~~~~~~#############################~~~~~~~~~#::::::::::::::::::::::::
:::::::::::::::::::::::::#~~~~~~~~~~~###########################~~~~~~~~~~~#::::::::::::::::::::::::
:::::::::::::::::::::::::#~~~~~~~~~~~~~########################~~~~~~~~~~~~#::::::::::::::::::::::::
:::::::::::::::::::::::::#~~~~~~~~~~~~~~~#####################~~~~~~~~~~~~~#::::::::::::::::::::::::
:::::::::::::::::::::::::#~~~~~~~~~~~~~~~~##################~~~~~~~~~~~~~~~#::::::::::::::::::::::::
:::::::::::::::::::::::::#~~~~~~~~~~~~~~~~~~~############~~~~~~~~~~~~~~~~~~#::::::::::::::::::::::::
:::::::::::::::::::::::::#~~~~~~~~~~~~~~~~~~~~~~~~~~~~~~~~~~~~~~~~~~~~~~~~~#::::::::::::::::::::::::
:::::::::::::::::::::::::#~~~~~~~~~~~~~~~~~~~~~~~~~~~~~~~~~~~~~~~~~~~~~~~~~#::::::::::::::::::::::::
:::::::::::::::::::::::::#~~~~~~~~~~~~~~~~~~~~~~~~~~~~~~~~~~~~~~~~~~~~~~~~~#::::::::::::::::::::::::
:::::::::::::::::::::::::#~~~~~~~~~~~~~~~~~~~~~~~~~~~~~~~~~~~~~~~~~~~~~~~~~#::::::::::::::::::::::::
:::::::::::::::::::::::::###################################################::::::::::::::::::::::::
::::::::::::::::::::::::::::::::::::::::::::::::::::::::::::::::::::::::::::::::::::::::::::::::::::
::::::::::::::::::::::::::::::::::::::::::::::::::::::::::::::::::::::::::::::::::::::::::::::::::::
::::::::::::::::::::::::::::::::::::::::::::::::::::::::::::::::::::::::::::::::::::::::::::::::::::
::::::::::::::::::::::::::::::::::::::::::::::::::::::::::::::::::::::::::::::::::::::::::::::::::::
::::::::::::::::::::::::::::::::::::::::::::::::::::::::::::::::::::::::::::::::::::::::::::::::::::
::::::::::::::::::::::::::::::::::::::::::::::::::::::::::::::::::::::::::::::::::::::::::::::::::::
::::::::::::::::::::::::::::::::::::::::::::::::::::::::::::::::::::::::::::::::::::::::::::::::::::
::::::::::::::::::::::::::::::::::::::::::::::::::::::::::::::::::::::::::::::::::::::::::::::::::::
::::::::::::::::::::::::::::::::::::::::::::::::::::::::::::::::::::::::::::::::::::::::::::::::::::
::::::::::::::::::::::::::::::::::::::::::::::::::::::::::::::::::::::::::::::::::::::::::::::::::::
::::::::::::::::::::::::::::::::::::::::::::::::::::::::::::::::::::::::::::::::::::::::::::::::::::
::::::::::::::::::::::::::::::::::::::::::::::::::::::::::::::::::::::::::::::::::::::::::::::::::::
::::::::::::::::::::::::::::::::::::::::::::::::::::::::::::::::::::::::::::::::::::::::::::::::::::
::::::::::::::::::::::::::::::::::::::::::::::::::::::::::::::::::::::::::::::::::::::::::::::::::::
::::::::::::::::::::::::::::::::::::::::::::::::::::::::::::::::::::::::::::::::::::::::::::::::::::
::::::::::::::::::::::::::::::::::::::::::::::::::::::::::::::::::::::::::::::::::::::::::::::::::::
::::::::::::::::::::::::::::::::::::::::::::::::::::::::::::::::::::::::::::::::::::::::::::::::::::
::::::::::::::::::::::::::::::::::::::::::::::::::::::::::::::::::::::::::::::::::::::::::::::::::::
::::::::::::::::::::::::::::::::::::::::::::::::::::::::::::::::::::::::::::::::::::::::::::::::::::
::::::::::::::::::::::::::::::::::::::::::::::::::::::::::::::::::::::::::::::::::::::::::::::::::::
::::::::::::::::::::::::::::::::::::::::::::::::::::::::::::::::::::::::::::::::::::::::::::::::::::
::::::::::::::::::::::::::::::::::::::::::::::::::::::::::::::::::::::::::::::::::::::::::::::::::::
::::::::::::::::::::::::::::::::::::::::::::::::::::::::::::::::::::::::::::::::::::::::::::::::::::
::::::::::::::::::::::::::::::::::::::::::::::::::::::::::::::::::::::::::::::::::::::::::::::::::::
